000010000100000
000000000000000
011111111100110
000010101000000
000000000000000
000000000011111
011100011110000
000000000000000
000000000011111
011000000000111
011111100000000